0	0	0	0	0	0	0	0	0	0
0	1	1	1	1	1	1	1	1	0
0	12	11	12	11	12	11	12	12	0
0	5	2	2	2	2	2	2	3	0
0	6	12	12	12	12	12	12	4	0
0	12	7	8	12	12	12	12	12	0
0	12	12	12	12	12	12	12	12	0
0	12	12	12	12	12	12	12	12	0
0	9	12	12	12	12	10	12	10	0
0	0	0	0	0	0	0	12	0	0