0	0	0	0	0	0	0	0	1	2	3	4	5	6	7	8
0	0	0	0	9	10	0	1	0	11	12	13	14	15	16	17
0	0	0	2	18	19	7	20	0	29	30	31	32	33	34	0
0	0	2	3	4	5	6	7	0	21	22	23	24	25	26	0
0	0	11	12	13	14	15	16	0	0	0	0	0	0	0	0
0	1	29	30	31	32	33	34	0	0	0	0	0	0	0	0
1	0	21	22	23	24	25	26	0	0	0	0	0	0	0	0
20	0	0	0	0	0	0	0	0	0	0	0	0	0	0	0
20	17	0	0	0	0	0	0	0	0	0	0	0	0	0	17
27	28	28	28	28	28	28	28	28	28	28	28	28	28	28	28