0	0	0	0	0	0	0	0	1	1	1	1	1	1	1	1
0	0	0	0	0	0	0	0	2	2	2	2	2	2	2	2
0	0	0	0	0	0	0	2	2	2	2	2	2	2	2	2
0	0	0	0	2	2	1	2	2	2	2	2	2	2	3	3
0	0	0	2	2	2	2	2	2	2	2	2	4	5	5	5
0	0	1	2	2	2	2	2	2	2	2	2	4	5	6	7
0	2	2	2	2	2	2	3	3	3	3	3	8	5	9	2
2	2	2	2	2	4	5	5	5	5	5	5	5	5	9	2
2	2	2	2	2	10	7	7	7	7	7	7	7	7	11	2
2	2	2	2	2	2	2	2	2	2	2	2	2	2	2	2